XXXXXXX
       
       
       
       
       
       
 
 
 
 
X 
 
 
 
       X 
 
 
 
 
   X
 
 
 
 
XX 
 
 
 
 
 
 
     XX
 
 
 
 
  X
  X
  X
 
 
 
 
X     X
X     X
X     X
X     X
X     X
X     X
 
 
  XXXX 
  X 
 XXX

 XXX X
 X X X  
 X XXX
  
 
  
 
 
XXXX
 

 
   XXXX
 
 
  X
 XXX
 XXX
  X 
 
 
 
X      X
X      X
X      X
X      X
X      X
X      X
X      X
X      X
X      X
X      X
X      X
X  X   X
X      X
X      X
X      X
X      X
X      X
X      X
X      X
X      X
XX     X
XX     X
XXX    X
XXX    X
XX     X
X      X
X      X
X X    X
X      X
X      X
X      X
X      X
X     XX
X     XX
X    XXX
X     XX
X     XX
X      X
X      X
X      X
X      X
X      X
XX    XX
XX    XX
XX    XX
XXX  XXX
XXX  XXX
XXX  XXX
XXX  XXX
XXX  XXX
XXX  XXX
XXX  XXX
XXX  XXX
XX    XX
X      X











