XXXXXXX
X     X
X     X
X     X
X     X
X     X
X     X
X     X
X     X
X     X
X     X
X     X
X     X
X     X
X     X
X     X
X     X
XX    X
X     X
X     X
X     X
XX    X
XX    X
XX   XX
X   XXX
X   XXX
X   XXX
X    XX
XX    X
XXX  
XXXX    
XXXX  
XXX  
XX    X
X    XX
X   XXX
X   XXX
X    XX
X     X
XX    X
XXX   X
XXX   X
XX    X
X     X
X    XX
X   XXX
X   XXX
X    XX
X     X
XX    X
XX    X
X     X
X   XXX
X     X
X     X
XXX   X
X     X
X     X
X   XXX
X     X
X     X
XX   XX
XX   XX
XX   XX
X     X

  XX
  XX
  
X     X
XX   XX
XX   XX
XX   XX
X     X
     XX
    XXX
    XXX
     XX
      X
X     X
X     X
XX    X
XX    X
X     X
X     X
      
   X 
  XXX
  XXX
   X


X      
XX     X
XX    XX
X    XXX
X   XXXX
X   XXXX
XX   XXX
XX    XX
XXX    X
XXX    X
XX     X
X      X

     XX
     XX


  XX
  XX


   XX
   XX


 XX
 XX

    XX
    XX


 XX
 XX



X     X
XX   XX
XX   XX
X     X











