XXXXXXX
X     X
X     X
X     X
X     X
X     X
X     X
X     X
X     X
X     X
X     X
X     X
X     X
X     X
X     X
X     X
X     X
X     X
X     X
X     X
X     X
X     X
XX   XX
XX   XX
XX   XX
X     X
X     X
      X

    X X

  X X X

X X X X

X X X X
       
X X X X
       
X X X X
       
X X X X
       
X X X X
       
X X X X
       
X X X X
  X     
X   X X
       
XXX X X
    X  
X X   X
       
X X XXX
  X    
X     X
    X  
X XXX X
  X X  
X X X X
X X X X
  X X 
  X X  
 XX XX
 X   X 
 X   X


 X X X
 X X X  
X     X
X     X
X     X
X X X X
X     X
X  X  X
X  X  X
X  X  X
X     X
X     X
X   X X
X     X
X     X
X X   X
X  X  X
X     X
X X   X
X     X
       
 XXX X  
 X X X 
 X XXX 
       
X     X
X    XX
X   XXX
X  XXXX
X XXXXX
X XXXXX
X  XXXX
X   XXX
X XXXXX
X  XXXX
X    XX
X X  XX
X XX  X
X XXX X
X XXX X 
X X   X
X X   X
X X XXX
X    XX
X X XXX
X X   X
X X   X
X  X  X
X   X X
XX  X X
XXX X X
XXX X X
X   X X
X  XX X
X XXX X
X     X
X XXX X
X XXX X
X XX  X
X  X  X
X     X
X     X
XXX XXX
X     X
X     X
X XXXXX
X     X
X     X
XXXXX X
X     X
X     X
X XXXXX
X     X
X     X
XXXXX X
X     X
X     X
X     X
XX X XX
X     X
X     X
X X X X

       
 X X X 

       
X XXX X

       
 XXXXX 
  XXX  
   X   
X     X
XXX XXX
XXX XXX
XXX XXX
XXX XXX
XX   XX
X     X











